#                                                             #
####################################### #######################
#      D#     #     #   #           #                         #
# ##### # ### # # # # # # # ####### # # ######### ########### #
# #       #   # # #   #   # #     # # #         # #           #
# # ####### # # # # ####### # # # # # ##### ### # # ##### ### #
# #         #   # # #   #   # # # #   #     #     # #   # #   #
# ############### # # # # # # # # ##### # ### ##### # # # # ###
#           #   # #   # # # # # #       # #   #     # # # #   #
########### # # # ##### # # # # ######### # ### # ### # # ### #
#   #     #   # #       #   # #         #   #   # #     #     #
# # # ### ##### ############# ######### ##### ### # ####### ###
# #   #   #             #   #       #       # #   # #     #   #
# ##### # # ####### ### # # ####### # # ### # # # # # ### ### #
#   #   # # #     # #     #           #   # # # # # #         #
### # ### # # ### # # ##### ############# # # # # # ###########
#   #     # # #   # # #   # #       #     # # #     #         #
# # # ##### # # # # # # # # # ##### # ##### # ####### ### ### #
# # #     # # # # # # # # #         # #     #         #   #   #
# # ##### # # # # # # # # ########### # ############### ### # #
# # #   # # # #   #   #   #   #     #   #             # #   # #
# # # # # # # ########### # # # # # ##### # ######### # # # # #
# # # #   #           #     # # # #     # #       #   # # # # #
# # # ####### ####### # # ### # # ##### # ####### # # # # # # #
# # #       # #     #   #     # #   #   #   #     # # #   #   #
# # ### ### # # ### # ####### # # # # # ### # # ### # ####### #
#   #   #     #   #   #     # # # # # #     # # #   #   #   # #
### # ### # ##### ##### ### # # # # # ####### # # # # # # # # #
#   # #   # #           #   # # #   #         #   # # #   #   #
# ### # # # # ### ####### ### # ########### ##### # # # #######
# #   # # #     # #         #   #   #     # #   # #   # #     #
# # ### # ##### # # ##### # ##### # # ### # # # # ### # # ### #
# #   # #     #   # #   # # #     # # #   # # # #     #   #   #
# ### # ##### # ### # # # # # ##### # # ### # # ########### ###
# #     #     #   # # # #   # #     # #   # # # #     #   #   #
# # ##### ####### # # # ### # # ##### ### # # # # ### # # ### #
#   #       #     # # #   #   #   #       #     # #     #     #
##### ##### # ##### # # # ####### # ############# # ######### #
#     #     #     # # # #   #     #             # # #         #
# # # # ##### ### # # # # # # # ############### # # # #########
# # # # #   #       #   # # # # #   #           # # # #       #
# # # # # # ############# # # # # # # ######### # # # # ##### #
# # # # # #       #     #   # #   #   #       #     # # #     #
# # # # # ####### # ### ### # ######### # ### ####### # # #####
# # # # #     #   #         #           #   #   #       #     #
# # # # ##### # # # ####################### ### # ########### #
# # #   #   # # # # #     #       #   #   #     #       #     #
# # ##### # # # # # # ### # ##### # # # # ############# # # ###
#   #     #     #   # #   # #     # # # #             # # #   #
##### # ############# # # # # ### # # # # ### ####### # # ### #
#     # #     #   #   # # #   #     # # #     #     # # #     #
# # ### # ### # # # ### # ##### ##### # ####### ### # # ##### #
# # #     #     # # #   # #     #   # #     #   #     #       #
# # # ##### # ### # # # # # ##### # # ### # # ### ######### ###
#   #   #   #   # #   # # #     # # #   # # #   # #       #   #
# ##### # ##### # ### # # ### # # # ### # # ### # # ##### ### #
# #   # # #     #     #     # # # #     #   #     # #     #   #
# # # # # # ############### # # # ######### # ##### # ##### # #
#   # #   #   #             # #     #       #     #   #   # # #
##### ##### # # ##### ### ### ##### # ########### # ### # # # #
#     #     # #   #     #     #   # #       #   #   #   # #   #
# ##### # ### ### # ### # ### # # # ####### # # ##### ### ### #
#       #         #     #     # #             #               #
############################### ###############################
#                                                              