#                                                             #
######################### #####################################
#     #                   #     #         #               #   #
##### # ######### ##### ### ### ####### ### ########### ### # #
#       #       # #   #     #       #     #       #   #     # #
# # ##### ##### ### # ### ### ##### ##### ####### # # ####### #
# # #   # #   #   # #   # # #   #   #   #     # #   #   #   # #
# # # ### # # ### # # ### # ### # ### ### ### # ####### # # # #
# # # #   # #   # # # #     # # #         #     #     # # # # #
# ### # ### ##### # ### ### # # ################# ### # # # # #
#   # #   # #     # #     # #   #         #   #   #   # # # # #
# # # ### # # # ### # ##### ############# # # # ### ##### # # #
# # #   # # # #   #   #   #             #   # # #   #     #   #
# # ### # # # ######### # ### ### ########### # # ### ##### ###
# # #   # # #           #   # #           #   # #   #     #   #
### # ### # ####### ####### # # ######### # ### ##### ####### #
#   #     # #     #     #   # # #     #   # #   #   #     #   #
# ### ##### # # ####### # ### ### ### # ### # ### # ##### # # #
# #   #     # #         # # #   # # # # #         #       # # #
### ####### # ########### # # # # # # # # ################# # #
#   #   #   #   #     #   # # # # #   # # # #       #       # #
# # # # # ####### ### # ### # # # # ##### # # ##### # ##### ###
# #   # #       #   # #     # #   #       # #   #   #     #   #
# ### ### ##### ##### ##### # ############# ### # ########### #
#   # #   #   #     #     #   #           #   # #   #   #     #
### # # ### # ##### # ### ##### ########### # # ### # # # #####
# # # #     #     # # #   #   # #   #       #   #   # #   #   #
# # ############# # ### ##### # # # # ####### ### # ######### #
#       #         #     #     #   #   #     # #   #   #     # #
# ### ### ############# # ### ######### ### ### ##### # ### # #
# #     # #           #   #   #       # # #   # #     # #   # #
# ##### # # ######### ######### ### # # # ### # # ##### # # # #
#     # # #     #     #     #   #   #   #     # #       # # # #
####### # # ### # ##### ### # ########### # ### ######### ### #
#   #   #   #   # #     #   #     #     # #   # #     #   #   #
# # # ####### ### # ##### ####### # ##### ### # # ### ### # ###
# # # #   #   #   # #   #       #   # #   #   #   #     # # # #
# # # # # # ### ### ### ####### ##### # ############### # # # #
# #   # # #   #     #       #   #   #   #       #       # # # #
# ##### # ### ### ### ##### ### # # # # ### ### # # ##### # # #
#       # #     #     # #   #   # #   #     #   # # #   # #   #
######### ############# # # # ############# ##### # # # # ### #
#   #   #       #     #   # #   #                 # # #   #   #
# # # ######### # ### ### ### # # ################# # ##### ###
# #   #   #   #   # #   #   # #   #   #       #   # #       # #
# ### # # # # ##### # ##### # ##### # # # ##### # # # ####### #
# #   # # # # #     # #   # #       # # #       # # # #   #   #
# # # ### # # # ### # # # # ######### ########### # ### # ### #
# # #   # # #     # #   #   #       # #     #     #     #   # #
### ### # # ##### ##### ### ####### # # ### # ############# # #
#   #   # # #     #     #   #         #   #   #     #     # # #
# ### ### # # ##### ######### ############# ### # ### ### # # #
#   #     # # #   # #   #   #     # #       #   # #     # #   #
### ####### # ### # # # # # ### # # # ########### # ##### # ###
#   #       #     #   #   # #   #   # #             #   # #   #
# # # ######### ########### ######### # ############# # # ### #
# # #   #     #   #     #     #     # # #       #     #     # #
# # ### # ### ##### ### # ### # ### # # # ##### ############# #
# #   # # #       #   # # #   # #   # # #     #             # #
# ##### # # ##### ### # # # ### # ### # ##### # ######### # # #
# #   #   # #         #   # #   #   # #       # #         # # #
# # # ##### # ####### ##### # ##### # ######### # ########### #
#   #       #       #     #   #       #         #             #
####################################### #######################
#                                                              