#                                                            D#
# #############################################################
# #       #           #                   #                   #
# # ##### # ######### # ################# # ################# #
# # #     # #   #   # # #   #             # #               # #
# # # ##### # # # # # # # # # ############# # ############# # #
# # #     # # # # # # # # # #             # # #   #       # # #
# # ##### # # # # # # # # # ############# # # # # # ##### # # #
# #     # #   #   # # # # # #           # # # # # #     # #   #
# ##### # ######### # # # # # ######### # # # # # ##### # #####
# #     # #       # # # # # #     #   # #   #   # #     #     #
# # ##### # ##### # # # # # ##### # # # ######### # ######### #
# #     # # #   # # # #   #     # # # #           # #         #
# ##### # # # # # # # ######### # # # ############# # #########
# #   # #   # # #   #         # # # # #       #   # # #       #
# # # # ##### # ############# # # # # # ##### # # # # # ##### #
# # # #     # #             # # # # # # #     # # # # #     # #
# # # ##### # ############# # # # # # # # ##### # # # ##### # #
#   # #   # # #             #   # # #   #     # #   #       # #
##### # # # # # ################# # ######### # ############# #
#     # # #   #     #       #     # #   #     #         #     #
# ##### # ######### # ##### # ##### # # # ############# # #####
# #   # # #   #     #     # #       # # # #           # #     #
# # # # # # # # ######### # ######### # # # ######### # ##### #
# # # # # # # # #         #         # #   # #   #     #     # #
# # # # # # # # # ################# # ##### # # # ######### # #
# # #   # # #   #         #   #   # #     # # # # #   #     # #
# # ##### # ############# # # # # # ##### # # # # # # # ##### #
# # #     #         #     # # # # # #     # # #   # # # #     #
# # # ############# # ##### # # # # # ##### # ##### # # # #####
#   # #   #   #     #       #   # # # #     # #     # # #     #
##### # # # # # ################# # # # ##### # ##### # ##### #
#     # # # # # #       #   #   # # # #     # # #     # #     #
# ##### # # # # # ##### # # # # # # # ##### # # # ##### # #####
#     # # # #   # #     # # # # # # # #     #   #       #     #
##### # # # ##### # ##### # # # # # # # ##################### #
#     # # # #   # # #   # #   #   #   #     #           #     #
# ##### # # # # # # # # # ################# # ######### # #####
# #     # # # # # # # # #                   # #   #   # #     #
# # ##### # # # # # # # ##################### # # # # # ##### #
# # #     #   # # # # #                 #     # # # # #       #
# # # ######### # # # ################# # ##### # # # #########
#   #     #     # # #         #   #     # #     #   #     #   #
######### # ##### # ######### # # # ##### # ############# # # #
#         # #     # #       # # # #       # #             # # #
# ######### # ##### # ##### # # # ######### # ############# # #
#           # #   # #     # # # #     #     #               # #
############# # # # ##### # # # ##### # ##################### #
#             # # # #     #   # #     # #       #   #       # #
# ############# # # # ######### # ##### # ##### # # # ##### # #
# #       #     #   #     #     #       #     # # # # #   # # #
# # ##### # ############# # ################# # # # # # # # # #
# #     # #         #     #     #           # #   #   # # #   #
# ##### # ######### # ######### # ######### # ######### # #####
#     # #     #   # # #         #     #   # # #       # #     #
##### # ##### # # # # # ############# # # # # # ##### # ##### #
#     #     # # # #   # #   #         # # #   # #     #     # #
# ######### # # # ##### # # # ######### # ##### # ######### # #
#           #   # #   # # # #     #     #       # #       # # #
################# # # # # # ##### # ############# # ##### # # #
#                 # # #   #     # #     #         # #     # # #
# ################# # ######### # ##### # ######### # ##### # #
#                   #           #       #           #       # #
############################################################# #
#U                                                             