#                                                            U#
# #############################################################
#                             #         #     #               #
# ########################### # # ##### # ### # ############# #
# #   #   #   #           #     #     #         #   #     #   #
# # # # # # # # ######### # # ####### ### ####### # # ### # ###
# # # # # # # # #       #   # #   #     # #     # #   #   #   #
# # # # # # # # # ##### ##### # # # # # # # ### # ##### ##### #
# #   # #   # # # #       #     # # # #     #   # #     #   # #
# ### # ##### # # # ##### # # ### # # ####### # # # # ### # # #
# #     #   # #   # #       # #   #         # # #   #   # # # #
# # ##### # # ##### # ####### # ########### # # ### ### # # # #
#       # # #     #   #     #   #         # # #   #   #     # #
####### # # ### # ##### # # ##### ####### # # ### ### ####### #
#   #   # # #   # #   # # #             #   #     #         # #
# # # # # # # ### # # # # ############# ##### ##### ####### # #
# # # # # # #   #   # #         #   #         #     #   #     #
# # # # # # ### ##### ######### # # # # ####### ##### # # #####
# # #   #     #             #   # # # # #       #   # # # #   #
# # ######### ############# # ### # # # # # ##### # # # # # # #
# # #   #   # #         #   #     # #   # #     # # #   #   # #
# # # # # # # # # ##### # # # ##### ##### ##### # # ### ##### #
#   # # # # # # # #     # # # #   #     #     # #   #         #
### # # # # # # # # ##### # # # # ##### ##### # ### # # ##### #
#   # # #   # #   #   #     #   # #     #     #   # # # #   # #
# ### # # ### # ##### # ######### # ##### # ##### # # # # # # #
# #   # #     # #   # #     #   # #     # #       #   #   #   #
# # ### ##### # # # # ##### # # # ##### # ### ##### ###########
#   #         #   # #   #     #   #   # #     #     #         #
# ### ######### ### # # # ######### # # ####### ##### ####### #
# #   #       # #   # # # #         #           #     #       #
# # ### # ### # # ### # # # ########### ######### ##### ##### #
# # #   # #   # #       #   #         # #             #     # #
# # # ### # ### # ### ####### ### ### # # # # ####### ##### # #
# #   #     #   #   #       #   # #   #   # # #   #     #   # #
# # # # ##### ##### ####### ### # # ### ### # # # # ### # # # #
# # #   #   #   #   #         #   # #   #   # # # # #   # # # #
# # ##### # ### # # # ####### ##### # ### ### # # # # ### # # #
# #     # #       # #   #       #   #   # #     # # #   #     #
# ##### # # ####### ### # ##### # ##### # # ##### # ### #######
# #     # # #       #   #       # #       # #   # # #         #
# # ##### # # ##### # ######### # # ####### # # # # # ####### #
#   #       # #     # #       # #         # # # # #   #     # #
# ### ####### # ##### # ### # # ####### # # # # # ##### # # # #
#           # # #     # #   # # #     # # #   # #     # # # # #
# ######### # # # # ### # ### # # # # # # ##### # ### # # # # #
# #         # #   # #   #     #   # # #     #   # #   # # # # #
# # ####### # ##### # ########### # # ### # # ### # # # # # # #
# # #       # #   #             # #     # # # #     # #   #   #
# # # ####### # # ############# # ### # # # # # ##### # ##### #
# # # #       # # #           # #   # # #   #     #   # #     #
# # # # # ##### # # ####### # # ### # # ######### # ### # #####
# # #   # #   # # # #     # # #     #   #   #   # #   #   #   #
# # ##### # # # # # # ### # # ########### # # # # ### ##### # #
# # #     # #   #   # #     # #         # #   #   #       # # #
# # # # ### ######### # ##### # # ##### # ### ##### # ### # # #
# #   #   # #         # #   #   # #     #   # #     # #   #   #
# ####### # # ######### # # # ### # ##### # # # ##### # # ### #
#       # #           # # # #   #   #     #   # #   #   # #   #
####### # ### ####### # # # ### # ### # ####### # # ##### # ###
#     #     # #     # # # # #   # #   #   #     # #   #   #   #
# ### ##### # # ### # # # # # # # # ##### # ##### ### # ##### #
#   #         #       #   #   #           #           #       #
### ########################################### ###############
#D                                                             