#                                                            D#
##################################################### #########
#   #     #     #                 #   #   #       #   #       #
# # # ##### ####### ############# # # # # # ##### ### # ##### #
# # #     #     #   # #     #   # # #   # # #   #   #   #     #
# ##### # ##### # # # # ### # # # # ##### ### # ### ##### #####
#     # #   #   # # # #   # # #   #     #     #     #   #   # #
##### # ### # ### ### # ### # ######### ### ######### # ### # #
#     #   # # #       # #   # #       #   # #         #     # #
# ### # ### # ####### # # ### # ##### ### # # # ############# #
#   #   #   # #       # #   #   #   #     #   # #             #
### ##### ### # ########### # ### ######### ### # ### ####### #
# # #   # #   #         #   #   #         # #   # #   #     # #
# # # # # # ########### # ##### ### ####### # ### # ### ### ###
#     # # # #   #   #   #     #     #     # #   # #     #     #
######### # # # # ### ####### ####### ### # ### ### ### ##### #
#   #     #   #   #   #   #   #   #     #   #   #   # # #     #
# ### # ### ####### ### # # ### # ##### ##### ### ### # # #####
# #   # # #       #   # #   #   # #     #   #       #   # #   #
# # ### # ####### # # # # ####### # ##### # ############# # # #
# #   # # #   #   # # # # #     # #       # #   #   #     # # #
# ### # # # ### ### # ### # ### # ######### # ### # # ##### # #
#     #   #     # # #   # # #           #   #     # #       # #
### ####### # ### # ### # # # ### ##### # ####### # ######### #
#       #   #   #   # # # # #   # #   # # # #   # #   #     # #
# ##### # ##### ### # # # # ##### # ### # # # # ### ### ### # #
# #   # #     #     #   #   #     #     # #   #   #   #   #   #
# ### ####### ############### ########### # ##### ### # # #####
#   # #   #   #           # #   #         # #   # #   # #     #
### # # # ### # ######### # ### # # ####### # # # # ### #######
#   #   #   # #   #           #   # # #     # # #   #   #     #
# ### ##### ### # # ######### ##### # # ### ### ##### # ### # #
#   # #   #   # # #   #     #     # #     #   # #     #   # # #
### # # # ### # # ### ##### ##### # ##### ### # # ####### # # #
# # #   # # #   #   #   #   #     #     #   # # #   #     # # #
# # ##### # ######### # # # ######### ##### # # ### # ##### # #
# # #   # #       #   #   # #       # #     # #     # #     # #
# # # # # # ##### # ######### ##### ### ##### ####### # #######
# # # #   # #   # #         #     #     #     #   #   #       #
# # # ####### # # ######### ##### # ####### ### # # ######### #
#   # # #     # #         #       # #     # #   # #     #     #
### # # # ### # ######### ######### # ### # # ######### # # ###
#   #     #   #   #       #       # #   #   #       #   # #   #
# ######### ##### ### ### # ##### # ### # ######### # # ##### #
# #     # #   #     #   #   #   # # #   # #   #   # # # #     #
# # ### # ### # ### ######### # # ### ##### # # # # # # # #####
# #   #   #   #   #       #   # #   #   #   # # #   # # #     #
# ### ### ### ########### # ### # # # # # ### # ### # # ##### #
# #   #       #     #   # # # #   #   # #   #   #   # #     # #
# # # ########### # # # # # # ############# ######### ##### # #
#   # #     #     #   # # #   # #         #   #           #   #
# ### # ##### ######### ### # # # ####### # ### ### ##### #####
#   # #       #       #   # #   # #   # # # #   #   #   # #   #
### # # ####### ### # ### # ##### # # # # # # # # ##### # # # #
# # # # #   #   #   #   # # #   # # #       # # #   #   #   # #
# # # # ### # ######### # # # # # # ######### # ### # ####### #
# # # # #   #   #   #   #   # #   # #   #     # #   #   #   # #
# # # # # # ### # # # ##### # # ##### # # ####### ##### # ### #
#   # #   # #     # # #     # # #   # # # #             #   # #
##### ##### ####### # # ##### ### # # # # # ############# # # #
#     #   #         # #     #   # #   #   #           #   # # #
# ####### ########### ##### # # # ################### # ### # #
#                   #     #   #   #                   #   #   #
############# #################################################
#                                                             U