#                                                             #
################# #############################################
#       #             #         #           #   #             #
# ##### # ########### # # ##### # # ####### # # # ########### #
# #     # #   #         # #   # # # #       # #   #       #   #
# # # ### # # # # ### ### # # # # # # # ### # # ### # ### # # #
# # # #     # # #   # #   # # # #     #     # #   # # #     # #
# # # # ##### # ### # # # # # # ######### ### ### # # # # ### #
# #   # #       #   #   # # #   #       # #     #   # # # #   #
# ##### # ####### ####### # ##### ##### # # ### ### # # # # ###
#       #         #     #     #   #   #   #   #     # # # #   #
# ####### ####### # ### ##### # ### # # ##### ####### # # ### #
# #     # #       # #         # #   #   #   # #   #     # #   #
# # ### # # # ##### # ####### # # ####### # # # # # ##### # # #
#     # # # #       #       #   #         # # # # #     #   # #
### # # # # ##### ### ##### ##### ####### # # # # ##### ##### #
#   #   # #   #   #   #     #   # #     # #   # #   #         #
# ####### # # # ### ### ##### # # # # # # # ### # # # #########
#     #   # #                 # #   # #   # #   # # # #   #   #
# ### # # # ############### ### ##### # ### # # # # # # # # # #
# #     #           #       #       #   #     #     # # # # # #
# # ############### # ####### ##### ##### ########### # # # # #
# # #     #       # # #   #   #     #   # #           # # # # #
# # # ### # ### # # # # # # # # ##### # # # ########### # # # #
# # #   #   #   # # #   #   #       # # #   #         #   # # #
# # ### ##### ### # ############### # # ##### ####### # ### # #
#     #     # #   #   #       #   # #         #       #     # #
### # ##### # # # # # # ##### # # # ########### ### ######### #
#   #   #   #   # # # # #     # # #   #           #           #
# ##### # # # ### # # # # ##### # ### # ######### #############
#     #   # # #   #     # #   # # #   # #   #     #           #
# ### # ### # # # ####### # # # # # # # # # # ##### ######### #
# #   # #   #   # #     # # #   #   # # # #   #   #           #
# # ### # ### ### # ### # # ### # ### # # # ### # ### ##### ###
#   #   # #   #   # #   # #   # #   #   # # #   #     #   #   #
# ### # # # ### ### # ### # # # ### ### # # # ######### # ### #
#   # # #   #     # # #   # #         # # #   #   #     # #   #
### # # ##### ### # # # ### ####### # # # # # # # # ### # # # #
#     #   #     # # #             # # #     #   # #     # # # #
# ####### # ### # # ### ####### # # # ########### ### ### # # #
# #       #   # #   #   #     # # # # #   #   #     # #   #   #
# # ######### # # ### ### ### # # # # # # # # # ### # # # #####
# # #       # #   #   #   #   # # #   # # # # # #   # # #     #
# # # ##### # ##### ### ### ### # # ### # # # # # ### # ### # #
# # # #   # #       #   #   #   # #       #     #     #   # # #
# # # # # # ######### ### ### # # ########### ########### # # #
#   #   # #     #   #     #   #   #   #     #           #   # #
# ####### ##### # # # ### # # ##### # # ### ########### ##### #
# #       #   # # # # #   # # #     #   #   #           #   # #
# # # ##### # # # # # # ### # # ######### ### # ####### # # # #
#   # #   # #     # # #     # # #       # #   # #     # # #   #
##### # # # ####### # ####### # # # ### # # # # # ### # # #####
#   #   # #       #   #       #   # #   #   #   #       # #   #
# # ##### ##### # ##### ##### ##### # ### ##### # ### ### # # #
# #     # #   # # #   # #   # #     #   #     # #     #   # # #
# ##### # # # # # # # # # # # # ####### ##### # ####### ### # #
#     # #   # #     # #   #   # #           #     #         # #
# ### # ### # ####### ######### # # ####### ##### # ######### #
#     #   # #     #     #   #   # #     #         #         # #
######### # ##### # ### # # # ### ##### # # ### ########### # #
#     #   #   #   #     # # #   #         # #   #         # # #
# ### # # # # # # ##### # # # # ########### # ### # ##### # # #
#       #   #   #       #     #             #     #       #   #
# #############################################################
#                                                              