#                                                             #
############################################### ###############
#     #       #   #       #       #     #   #     #           #
# ### # ##### # # # ### # # ##### # ### # # # ### # # ####### #
# #   # #   #   # #   # #   #     #   # # # #   #   # #     # #
# # # # # # # # # ### # ##### ####### # # # ### ##### # ### # #
#   # # # #   # #     #   #       #   # #   #   #     #       #
### # # # ##### # ##### # # ##### # # # ### # ### #############
#   #   #     # # #   # # #     #   # #       #   #     #     #
# # # ####### # # # # # # ##### ##### ######### ### ### # # # #
# # # #     # # # # # #         #           #     # #   # # # #
# # # # ### # # # # # ########### ######### # ### # # # # # # #
#   #         # # #   #     #   # #       # #   # #   # # # # #
############### # ### # ### # # # # ##### # # # # # ### # # # #
#     #         #     # #   # # # # #   # #   #   # #     # # #
# # # # # ############# # ### # # # # # # ######### # ##### # #
# # #   # #             #     # # # # # # #       # # #     # #
# # ##### # ######### ######### # # # # # # ##### # # # ### # #
#       # # #       # #     #   #   #   # # #     # # #     # #
####### # # # ##### # # ### # ##### ### # # # ##### # ####### #
#     # #   # #     # # #     #   #   # #   # #     #       # #
# # # # ##### # ##### # # ##### # ### # ### # # ########### # #
# # #       # #     #   #       # #   #     # # #       #     #
# # ####### # ##### # ####### # # # ######### # # ##### # #####
#     #     #     # # #   #   # # # #           #     #   #   #
##### # # ####### # # # # # ### # # # ############### ##### # #
#       #   #     # #   # #   #   #   #     #     #         # #
# ######### # ##### ##### ### ##### ### ### # # # # ######### #
# #         # #   #   #   #         #   #   # # #   #   #     #
# # ######### # # # # # ### # ####### ### # # # ##### # # #####
#       #   # # # # # #     # #         # # # # #     #   #   #
####### # # # # # # # ####### # # ### # # # # # # ######### # #
#     # # # #   #   #       #   # #   # #   # # # #         # #
# # # # # # # ############# # ### # ### # ### # # # # ####### #
# # # #   # # #           #   #   #     # #   # #   #         #
# # # ##### # # ######### ##### # ### ### # # # ###############
#   #       #       #   #     # #   #   #   #   #       #     #
# ####### ##### ### # # ##### # ### ### # ####### ##### # ### #
#   #   # #   # #     #     # # #       #   #   #       # #   #
# # # # # # # # # ######### # # # # ####### # # ### ##### # # #
# # # #   # # #   #       #     # # #     # # #   # #   #   # #
# # # ##### # ### # ##### ####### # # ### # # ### # # # ##### #
#   # #   #       #   #     #   # # # #     #     #   #     # #
##### # # ### ####### # ### # # # # # # ####### ########### # #
#   # # #     #     # # #   # # #   #   #       #         #   #
# # # # ####### ### # # # ### # ####### # ##### # # ### # # ###
# # # #       #   #     # #   #       # # #   #   #     # #   #
# # # # ##### ### ####### # ####### # # # # # ####### ### ### #
# # # #       #   #     #   #     # # #   # # #     #   #   # #
# # # ######### # # ### # ### # # # # ##### # # ### ### ### # #
# # #   #   #   # # #     #   # #     #   # #   #     #     # #
# # ### # # # ### # # ##### ### ####### # # ##### ### ####### #
# #     # # #     # #   #       #   #   #   #   # #         # #
# ####### # # ### # ### # # ##### # # ####### # # # # ##### # #
# #       # # #   #   # # # #     #   #       # #   # #     # #
# # # ##### # # ##### # # # # ##### ### ####### ##### # # ### #
# # # #     #       # # #   #     #     #     # #   #   # #   #
# # # # ####### ### # # ######### ####### ### # # # ##### # ###
#   # # #       #   # # #       #       # #     # #     #     #
##### # # ### ### ### # # ##### # ##### # # ##### ### # ##### #
#     # #   #   #   #     #   # # #     #   #   #   # # #   # #
# ### # # # ### ### ####### # # # # ### # ### # ### # # # # # #
#     #   #                 #     #     #     #     #     #   #
################################################### ###########
#                                                              