#                                                            U#
################### ###########################################
#               #       #       #                   #         #
# ############# # # ### # # ### # ####### ######### # ####### #
# #       #   #   # #   # #       #     #     #     # #     # #
# # ##### # # ##### # ### ######### ### ##### # ### # # ### # #
#   #     # # #     #     #       # #       #       #       # #
# ### ##### # # ######### # ### # # # # ### ### ############# #
#   #     # #   #     #   #     #     #     #   #           # #
# # ##### # ##### # # # ################# ### # # # ####### # #
# # #     #   #   # # #     #       #   #   # # # # #       # #
# # # ####### # ### # ##### # ##### # # ### # # # # # # ##### #
#   #   #             #   #   #   # # #   # #   #   # # #   # #
####### # ############# # # ### # # # ### # ######### # # # # #
#       #           #   # #     #   #     # #   #   # # # #   #
# # ### ########### # ### ### ##### # ### # # # # # # # # # ###
# #   # #   #     # # #     # #     #   # # # # # #   # # #   #
# ### # # # # # # # # # ### # # # ##### # # # # # ### # # ### #
# #   # # #   # # # # #     #   #     # #   #   #     # # #   #
# # ### # ### # # # # ####### ####### # ####### ####### # # # #
# #     # #   #   #         # #       # #                 # # #
# # ##### # ############# # # # ### ### # ##### ########### # #
# # #     #   #     #   # # #   #   #     #     #         #   #
# # # ##### # # ### # # # # ### # ### ##### ##### ####### #####
# # #       # # #   # # #   #   #     #   # #     #           #
# # ######### # # ### # ### # ######### # # # ##### # ####### #
# #   #       #     # #   # #   #   #   # #   #   # # #       #
# ### # ########### # ### # ### # # # # # ### # # # # # #######
#       #   #   #   #   #         # # # # #   # # #   # #     #
######### # # # # ##### ########### # # # # ### # ##### # # # #
#         #   # # #   #       #   #     # #   # #   #   # # # #
# ######### ### # # # ####### # # ####### ### # # # # ### # # #
# #         #   # # # #     #   #           # #   # #   #   # #
# # ######### ### # # # ### ### ##### ##### # # ### ### ##### #
# # #         #   # #   #     #   #   #   #   # #   #         #
# # # ######### ### ##### # # ### # ### # ##### # ### # #######
# #       #           #   # #     # #   #   #   # #   # #     #
# ### ### # ######### # ### ####### # # ### # ### # ### # ### #
#   #   #   #       #       #     #   #   # #     # #   #   # #
### ### ##### # ### ##### # # ### ####### # ##### # # # ### # #
#       #   # #         # #         #     # #       # #   # # #
# ####### # # ######### # ### ##### # ##### # ####### ### # # #
# #     # # #   #   #   # #   #   #   #     # #     #   # # # #
# # ### # # ### # # # # # # ### # # ### ##### # ### ### # # # #
#   #   # #   #   # # #   # #   #   #   #   # # #       # #   #
##### # # # # ### # # ##### # ####### ### # # # # ####### # ###
#     #   # # #   # #     #   #         # #   # # #     # #   #
# ######### # # ### ##### ##### # ##### # ##### # # ### # ### #
#             # #   #     #     #     # #     # # # #   # #   #
# ############# # ### ##### ##### ### # ##### # # # # ### # # #
# #           # # #         #   # #   #     #   # # #       # #
# # ### ##### # # # ######### # # # ####### ##### # ######### #
#   #   #   # #   #   #       # #   #           #   #         #
##### ### # # ####### # # ### # ##### ######### ##### ##### ###
#     #   #         #   #   #   #     #         #     #   #   #
# ##### ########### ####### ### # ##### ######### ##### # ### #
# #           #   # #         # # #     #     #   #     #     #
# # ### ##### # # # # ####### # # # ##### # # # ### # #########
# #     #   #   # # #           #   #     # # #   # #     #   #
# # ##### # ### # # ########### ##### ##### # ### # ##### # # #
# #     # # #   # # #       #   #     #     #   # #     #   # #
# ### # # # # ### # # ##### # # # # ### ####### # # ### # ### #
#     #   #         #     #   #   #               #     #     #
######################### ########################### #########
#D                                                             