#                                                            D#
################# #############################################
#                 #   #     #       #           #   #     #   #
# ######### ### ### # # # # # ##### # ######### # # # ### # # #
#   #     #   #   # #   # #   #     #         # # #         # #
# # # ### ### ### # # ### ##### ############# # # # ######### #
# # #   # #   #     #   #           #           #   #         #
# # ### # # ### # ##### ### ####### # # ############# ### #####
# #   #   #   # # #   # #   #         #           #     # #   #
# ### ### ### # # # # # # ### # ################# # # # # # # #
# #     # #   #     #   # #   # #   #         #   # # #   # # #
# # ### # # ############# # ### # # # ####### # # # # ### # # #
# # #   # # #   #       # #   # # #   #   #   # #   # #     # #
# # # # # # # # # # ### # ### # # # ### # # # # ##### # # ### #
# #   # # #   #   # #   #     #   #   # #   # #     # # #   # #
# ### # # ### # ### # ####### ####### # ##### ##### # # ### # #
#     #     # # #     #   #   #   #   #   #     #   # # #     #
########### # # # # ### # # ### # # ##### # ### # ### # # # ###
#           # # # # #   # #   # # #       #     #   # # # #   #
# ########### # # # # # # ### # # # ############### # # # ### #
#     #     # # #     #   #   # # #   #       #     # #       #
##### # ### # # ######### # # # # ### # ##### # ##### #########
#   #   #     # #         # # # #     #         #   # #       #
# # # ### ##### # ##### ### # # ################# # # # ##### #
# # #     #     #     # #   # #   #         #     # # # #     #
# # ####### ####### # # # # # ### # # ##### # ##### # # # ### #
# #     #         # # # # # # #   # #       #   #   #     #   #
# # ### # ####### # # # # # # # ### ########### # ######### ###
# # #   #         #   #   #   #   #   #           #       #   #
# # # # ########### ### ######### ### # # ######### ##### ### #
# # # #           #     #   #   #     # #     #     #         #
# # # ########### ####### # # # # ##### ##### # ### # #########
#   #       #   #     #   #   #   #   #     # #     #   #     #
# ######### # # ##### # ####### ### # ##### # ####### # # ### #
# #     #   # # #   # # #   #   #   #     #           #   #   #
# # ### # ### # # # # # # # # ### ####### ################# # #
#       # #   #   # # # # #   #       #   #       #       # # #
######### # ##### # # # # ##### ##### # ### # ### # ##### # # #
#   #     #     # # # # #             # #   # #   # #     # # #
# # # ######### # # # # ############### # ### # ### # # ### # #
# #   #           # # #           #   # #     #   # # # #   # #
# ##### ########### # # ######### # # # ######### # # # # ### #
#   #   #   #       # # #     #     # #   #     # #   #       #
### # ### # # ####### # # ### # ##### ### # ### # #############
#   # #   # # #         #   #       #     # #   # #           #
# ### # ### # # # ######### ####### ####### # ### # ######### #
#   # #   # # # # #   #   # #   #   #     #     # #   #     # #
### # ### # # # # # # # # # # # # # # ### ##### # ### # ### # #
#     #   # #   #   #   # #   #   #   #         #     #   #   #
# ##### ### ############# ####### ### # # ##### ##### # # ### #
# #   # #   #   #   #   # #     #     # # #     #   # # #   # #
# # # # # ### # # # # # # # ### ####### # # # ### # # # ### # #
#   # # #     # # # # #   #           # # # #     # # #   #   #
##### # ####### # # # # ############# # # # ##### # # # # ### #
#   # # #       #     # #           # #   #     #   #   #   # #
# # # # # ##### ### ### # ######### # ### ##### ########### # #
# #   # # #   # #   #   #         # #   # #   # #         # # #
# ### # # # # # # ### ########### # ### # # # # # ####### # # #
#     # #   #   # #   #         # #   # #   #   #       #   # #
####### ### ##### # ### ####### # ### # # ######### ### ##### #
#     # #   #   # # #           #   #     #       # #         #
# ### # # ### # # # # ########### # ####### ### # # # ####### #
#       #     #   #               #             #   #         #
################################################# #############
#U                                                             