#                                                             #
# #############################################################
# #           #               #               #       #       #
# # ######### # ############# # ############# # ##### # ##### #
# # #       # # #       #     #     #       # # #     #     # #
# # # ##### # # # ##### # ######### # ##### # # # ######### # #
#   # #     # # # #     #         # #     # #   # #         # #
##### # ##### # # # ############# # ##### # ##### # ######### #
#     #       #   # #   #   #   # #       # #     # #         #
# ################# # # # # # # # ######### # ##### # #########
#     #       #   # # # # # # # #         # #     # # #       #
##### # ##### # # # # # # # # # ######### # ##### # # # ##### #
#     # #     # # #   # # #   #           # #     # # # #   # #
# ##### # ##### # ##### # ################# # ##### # # # # # #
# #   # #       #     # # #   #             #       #   # # # #
# # # # ############# # # # # # ######################### # # #
# # # #     #       # # # # # #     #           #       # # # #
# # # ##### # ##### # # # # # ##### # ######### # ##### # # # #
#   # #     #     # #   # # #     # #     #     # #     # # # #
##### # ######### # ##### # ##### # ##### # ##### # ##### # # #
#   # # #         # #     # #   # #     # #       #       #   #
# # # # # ######### # ##### # # # ##### # #####################
# # # # # #   #     #     # # # #     # #     #               #
# # # # # # # # ######### # # # ##### # ##### # ############# #
# #   #   # # #     #   # #   #     # #     # # #       #     #
# ######### # ##### # # # ######### # ##### # # # ##### # #####
#           # #   # # # #     #     # #     # # #     # # #   #
############# # # # # # ##### # ##### # ##### # ##### # # # # #
#   #       # # # #   # #     #     # #     # # #   # #   # # #
# # # ##### # # # ##### # ######### # ##### # # # # # ##### # #
# # #     # # # #       #     #     #       #   # # # #   # # #
# # ##### # # # ############# # ################# # # # # # # #
# #       #   # #   #   #   # #         #         #   # # # # #
# ############# # # # # # # # ######### # ############# # # # #
# #   #   #     # # # # # # # #       # #     #   #   # #   # #
# # # # # # ##### # # # # # # # ##### # ##### # # # # # ##### #
# # # # # #       #   # # #   # #   # # #   # # # # # #     # #
# # # # # ############# # ##### # # # # # # # # # # # ##### # #
#   # # #             # # #     # # # # # # # # #   #     # # #
##### # ############# # # # ##### # # # # # # # ######### # # #
#     # #           # # # # #     #   #   # # # #         # # #
# ##### # ######### # # # # # ############# # # # ######### # #
#     # # #   #     # # #   #     #   #     #   #     #     # #
##### # # # # # ##### # ######### # # # ############# # ##### #
#     # # # # #       #     #     # # #         #     # #     #
# ##### # # # ############# # ##### # ######### # ##### # #####
#     # #   #             # # #     #           #     # #     #
##### # ################# # # # ##################### # ##### #
#     #     #   #       # # # #     #           #     # #     #
# ######### # # # ##### # # # ##### # ######### # ##### # #####
#         # # # #     # #   # #     #         # #     # # #   #
######### # # # ##### # ##### # ############# # ##### # # # # #
#       # # # #       #       #     #         #     # # # # # #
# ##### # # # ##################### # ############# # # # # # #
#     # # # #     #                 #             # # # #   # #
##### # # # ##### # ############################# # # # ##### #
#     #   # #   # #     #                   #     #   #     # #
# ######### # # # ##### # ################# # ############# # #
#     #   # # # #     # #         #   #   # # #       #     # #
##### # # # # # ##### # ######### # # # # # # # ##### # ##### #
#     # # #   # #     # #         # # # # #   # #     # #     #
# ##### # ##### # ##### # ######### # # # ##### # ##### # #####
#       #       #       #           #   #       #       #     #
############################################################# #
#                                                             #